 - - - - - - - 
|     |       |
 - -   - - -   
|   |     |   |
   -   - -   - 
| |       |   |
 - - -   -   - 
|       |     |
 - - - - - - - 
0,0
4,6